13 13
MMMMMMMMMMMMM
M..BBB......M
M.M.MBMBMBM.M
M.BB.BBBBBBBM
M.M.MBMBM.MBM
M.B.BB.B.BBBM
MBM.MBMBMBM.M
MBBB.BBB...BM
MBMBMBM.MBMBM
MBBB.B.BBB..M
M.MBM.MBMBM.M
MP.DB.BB.B..M
MMMMMMMMMMMMM
