13 13
MMMMMMMMMMMMM
MPBB..BBBB..M
M.MBM.MBM.M.M
MBBBBB.B.BBBM
M.MBM.MBM.MBM
MB.BBBBBB..BM
MBM.M.M.M.M.M
MB..BBBB.BBBM
M.M.M.MBMDMBM
MBBB.BB..BBBM
MBMBM.M.M.MBM
MBBBB...BBBBM
MMMMMMMMMMMMM
