13 13
MMMMMMMMMMMMM
M.BBBBBBBBBBM
M.M.MBMBMBMBM
MBBBBBB.BBBBM
M.M.M.M.MBMBM
MBBB...BBBB.M
M.M.M.M.MBM.M
M....BBBBBBPM
MBM.MBMBMBMBM
MDBBBB...BBBM
MBMBM.M.M.MBM
MBBBBBBBB..BM
MMMMMMMMMMMMM